Total Modules: 493
Round 1
    libosclmemory: external/opencore/oscl/oscl/osclmemory
    libsafe_iop: external/safe-iop
    libdrm2: frameworks/base/media/libdrm/mobile2
    libxml2: external/libxml2
    libpvomx_proxy_lib: external/opencore/codecs_v2/omx/omx_proxy
    libpvrtspinterface: external/opencore/modules/linux_rtsp/core
    libpvmp4interface: external/opencore/modules/linux_mp4/core
    libpvgsmamrparser: external/opencore/fileformats/rawgsmamr/parser
    libsqlite3_android: external/sqlite/android
    libprotocolenginenode_common: external/opencore/nodes/pvprotocolenginenode/protocol_common
    libpvrtsp_cli_eng_node: external/opencore/protocols/rtsp_client_engine
    libpvstreamingmanagernode: external/opencore/nodes/streaming/streamingmanager
    libpvfileoutputnode: external/opencore/nodes/pvfileoutputnode
    libpvpvxparser: external/opencore/fileformats/pvx/parser
    libpvmf: external/opencore/pvmi/pvmf
    libandroidpv: external/opencore/android
    libpvlatmpayloadparser: external/opencore/protocols/rtp_payload_parser/util/build
    librtprtcp: external/opencore/protocols/rtp
    libomx_aac_component_lib: external/opencore/codecs_v2/omx/omx_aac
    libandroidpvauthor: external/opencore/android/author
    libosclerror: external/opencore/oscl/oscl/osclerror
    libpvmioaviwavfileinput: external/opencore/pvmi/media_io/pvmi_mio_avi_wav_fileinput
    libomx_mastercore_lib: external/opencore/codecs_v2/omx/omx_mastercore
    libhost: build/libs/host
    libpvmp3ff: external/opencore/fileformats/mp3/parser
    libomx_common_lib: external/opencore/codecs_v2/omx/omx_common
    libosclregcli: external/opencore/oscl/oscl/osclregcli
    libdex: dalvik/libdex
    libpvrtspreginterface: external/opencore/modules/linux_rtsp/node_registry
    libpvoma1passthruplugin: external/opencore/pvmi/content_policy_manager/plugins/oma1/passthru
    libpvomxbasedecnode: external/opencore/nodes/pvomxbasedecnode
    libosclproc: external/opencore/oscl/oscl/osclproc
    libpvavcdecoder: external/opencore/codecs_v2/video/avc_h264/dec
    libosclregserv: external/opencore/oscl/oscl/osclregserv
    libpv_config_parser: external/opencore/codecs_v2/utilities/pv_config_parser
    libSR_AudioIn: external/srec/audio/AudioIn/UNIX/src
    libpv_avc_common_lib: external/opencore/codecs_v2/video/avc_h264/common
    libomx_baseclass_lib: external/opencore/codecs_v2/omx/omx_baseclass
    libmp4recognizer_utility: external/opencore/fileformats/mp4/parser/utils/mp4recognizer
    libpvaacffparsernode: external/opencore/nodes/pvaacffparsernode
    libpvomxvideodecnode: external/opencore/nodes/pvomxvideodecnode
    libpvmfrecognizer: external/opencore/pvmi/recognizer
    libpvmediaoutputnode: external/opencore/nodes/pvmediaoutputnode
    libpvmediainputnode: external/opencore/nodes/pvmediainputnode
    libjpeg: external/jpeg
    libomx_avc_component_lib: external/opencore/codecs_v2/omx/omx_h264
    libprotocolenginenode_download_common: external/opencore/nodes/pvprotocolenginenode/download_protocols/common
    libpvmp4ffparsernode: external/opencore/nodes/pvmp4ffparsernode
    libcolorconvert: external/opencore/codecs_v2/utilities/colorconvert
    librtppayloadparser: external/opencore/protocols/rtp_payload_parser
    libcpm: external/opencore/pvmi/content_policy_manager
    libpvamrwbdecoder: external/opencore/codecs_v2/audio/gsm_amr/amr_wb/dec
    libpvid3parcom: external/opencore/fileformats/id3parcom
    libpvplayer_engine: external/opencore/engines/player
    libpvmiofileinput: external/opencore/pvmi/media_io/pvmi_mio_fileinput
    libosclio: external/opencore/oscl/oscl/osclio
    libpvmimeutils: external/opencore/baselibs/pv_mime_utils
    libpvdecoder_gsmamr: external/opencore/codecs_v2/audio/gsm_amr/amr_nb/dec
    libpvjitterbuffernode: external/opencore/nodes/streaming/jitterbuffernode
    libpv_omx_interface: external/opencore/codecs_v2/omx/omx_sharedlibrary/interface
    libpvmedialayernode: external/opencore/nodes/streaming/medialayernode
    libprotocolenginenode_ps: external/opencore/nodes/pvprotocolenginenode/download_protocols/progressive_streaming
    libft2: external/freetype
    libpvmp4ffcomposer: external/opencore/fileformats/mp4/composer
    libpvamrffrecognizer: external/opencore/pvmi/recognizer/plugins/pvamrffrecognizer
    libpvdownloadinterface: external/opencore/modules/linux_download/core
    libpvmp4decoder: external/opencore/codecs_v2/video/m4v_h263/dec
    libpv_aac_dec: external/opencore/codecs_v2/audio/aac/dec
    libpvwav: external/opencore/fileformats/wav/parser
    libosclutil: external/opencore/oscl/oscl/osclutil
    libpvframemetadatautility: external/opencore/engines/adapters/player/framemetadatautility
    libomx_m4v_component_lib: external/opencore/codecs_v2/omx/omx_m4v
    libpvencoder_gsmamr: external/opencore/codecs_v2/audio/gsm_amr/amr_nb/enc
    libomx_amr_component_lib: external/opencore/codecs_v2/omx/omx_amr
    libpvmp4ff: external/opencore/fileformats/mp4/parser
    libpv_rtsp_parcom: external/opencore/protocols/rtsp_parcom
    libunit_test: external/opencore/oscl/unit_test
    libscsp: external/opencore/fileformats/scsp
    libprotocolenginenode_shoutcast: external/opencore/nodes/pvprotocolenginenode/download_protocols/shoutcast
    libpvwavffparsernode: external/opencore/nodes/pvwavffparsernode
    libpvmp3: external/opencore/codecs_v2/audio/mp3/dec
    libpvomxencnode: external/opencore/nodes/pvomxencnode
    libpvmp3ffparsernode: external/opencore/nodes/pvmp3ffparsernode
    libpvdownloadmanagernode: external/opencore/nodes/pvdownloadmanagernode
    libpvaacffrecognizer: external/opencore/pvmi/recognizer/plugins/pvaacffrecognizer
    libtinyxml: external/tinyxml
    libpvmp4ffcomposernode: external/opencore/nodes/pvmp4ffcomposernode
    libmincrypt: system/core/libmincrypt
    liboscllib: external/opencore/oscl/oscl/oscllib
    libpvjitterbuffer: external/opencore/nodes/streaming/jitterbuffernode/jitterbuffer/common
    libomx_amrenc_component_lib: external/opencore/codecs_v2/omx/omx_amrenc
    libprotocolenginenode_pdl: external/opencore/nodes/pvprotocolenginenode/download_protocols/progressive_download
    libgetactualaacconfig: external/opencore/codecs_v2/audio/aac/dec/util/getactualaacconfig
    libomx_m4venc_component_lib: external/opencore/codecs_v2/omx/omx_m4venc
    libpvavch264enc: external/opencore/codecs_v2/video/avc_h264/enc
    libpvamrffparsernode: external/opencore/nodes/pvamrffparsernode
    libpvmp4reginterface: external/opencore/modules/linux_mp4/node_registry
    libpixelflinger_static: system/core/libpixelflinger
    libpvauthorengine: external/opencore/engines/author
    libpvm4vencoder: external/opencore/codecs_v2/video/m4v_h263/enc
    libpvaacparser: external/opencore/fileformats/rawaac/parser
    libosclbase: external/opencore/oscl/oscl/osclbase
    libgif: external/giflib
    libomx_mp3_component_lib: external/opencore/codecs_v2/omx/omx_mp3
    libpv_http_parcom: external/opencore/protocols/http_parcom
    libjavacore: dalvik/libcore
    libpvsdpparser: external/opencore/protocols/sdp/parser
    libpvgendatastruct: external/opencore/baselibs/gen_data_structures
    libpng: external/libpng
    libpvthreadmessaging: external/opencore/baselibs/thread_messaging
    libpvavifileparser: external/opencore/fileformats/avi/parser
    libfdlibm: external/fdlibm
    libpvomxaudiodecnode: external/opencore/nodes/pvomxaudiodecnode
    libpvmiofileoutput: external/opencore/pvmi/media_io/pvmiofileoutput
    libpvmp3ffrecognizer: external/opencore/pvmi/recognizer/plugins/pvmp3ffrecognizer
    libpvoma1passthruplugininterface: external/opencore/modules/cpm_oma1_passthru
    libpvmediadatastruct: external/opencore/baselibs/media_data_structures
    libomx_avcenc_component_lib: external/opencore/codecs_v2/omx/omx_h264enc
    libm4v_config: external/opencore/codecs_v2/utilities/m4v_config_parser
    libthreadsafe_callback_ao: external/opencore/baselibs/threadsafe_callback_ao
    libpvdownloadreginterface: external/opencore/modules/linux_download/node_registry
    libaudiointerface: frameworks/base/libs/audioflinger
    libpvwavffrecognizer: external/opencore/pvmi/recognizer/plugins/pvwavffrecognizer
    libpvjitterbufferrtp: external/opencore/nodes/streaming/jitterbuffernode/jitterbuffer/rtp
    libomx_queue_lib: external/opencore/codecs_v2/omx/omx_queue
    libpvmp4ffrecognizer: external/opencore/pvmi/recognizer/plugins/pvmp4ffrecognizer
    libprotocolenginenode_base: external/opencore/nodes/pvprotocolenginenode/base
    libpvsocketnode: external/opencore/nodes/pvsocketnode
    libbz: external/bzip2
    libpv_amr_nb_common_lib: external/opencore/codecs_v2/audio/gsm_amr/amr_nb/common
    libpvfileparserutils: external/opencore/fileformats/common/parser
Round 2
    acp: build/tools/acp
Round 3
    libESR_Portable: external/srec/portable
    dumpkey: system/core/libmincrypt/tools
    ant: prebuilt/common/ant
    libswt-gtk-3236: prebuilt/linux-x86/swt
    jcommon-1.0.12: prebuilt/common/jfreechart
    libarity: packages/apps/Calculator
    jfreechart-1.0.9: prebuilt/common/jfreechart
    jasmin.jar: dalvik/dx
    nmea: frameworks/base/location/data
    hprof-conv: dalvik/tools/hprof-conv
    com.example.android.platform_library.xml: development/samples/PlatformLibrary
    safe_iop_test: external/safe-iop/testsuite
    location: frameworks/base/location/data
    libswt-cairo-gtk-3236: prebuilt/linux-x86/swt
    test_defs.xml: development/testrunner
    fs_get_stats: build/tools/fs_get_stats
    dmtracedump: dalvik/tools/dmtracedump
    idegen: development/tools/idegen
    showslab: system/extras/showslab
    ninepatch: development/tools/ninepatch
    google-framework: frameworks/opt/com.google.android
    android.policy: frameworks/policies/base
    org.eclipse.equinox.common_3.2.0.v20060603: prebuilt/linux-x86/swt
    libaes: external/aes
    atree: build/tools/atree
    libvorbisidec: external/tremor
    libswt-atk-gtk-3236: prebuilt/linux-x86/swt
    mkbootimg: system/core/mkbootimg
    cmu2nuance: external/srec/config/en.us
    jfreechart-1.0.9-swt: prebuilt/common/jfreechart
    dx: dalvik/dx
    jdwpspy: development/tools/jdwpspy
    libsqlite3_phonetic_string_utils_test: external/sqlite/android
    pvplayer: external/opencore
    mkbootfs: system/core/cpio
    kxml2-2.3.0: prebuilt/common/kxml2
    androidprefs: development/tools/androidprefs/src
    signapk: build/tools/signapk
    run-core-tests: dalvik/libcore
    kcm: build/tools/kcm
    clearsilver: external/clearsilver/java-jni
    line_endings: development/tools/line_endings
    jasmin: dalvik/dx
    aidl: frameworks/base/tools/aidl
    libzipfile: system/core/libzipfile
    bison: external/bison
    icudata: build/tools/bin2asm
    org.eclipse.jface_3.2.0.I20060605-1400: prebuilt/linux-x86/swt
    bookmarks.xml: frameworks/base/packages/SettingsProvider/etc
    latencytop: system/extras/latencytop
    liblog: system/core/liblog
    preload: frameworks/base/tools/preload
    su: system/extras/su
    android: development/tools/sdkmanager/app/etc
    org-netbeans-api-visual: prebuilt/common/netbeans-visual
    run-core-tests-on-ri: dalvik/libcore
    libpagemap: system/extras/libpagemap
    org.eclipse.core.commands_3.2.0.I20060605-1400: prebuilt/linux-x86/swt
    apicheck: build/tools/apicheck
    libfst: external/srec/tools/thirdparty/OpenFst/fst/lib
    browsertestplugin: external/webkit/WebKit/android/plugins/sample
    org-openide-util: prebuilt/common/netbeans-visual
    event-log-tags: system/core/logcat
    sound: system/extras/sound
    googlelogin-client: frameworks/opt/com.google.android.googlelogin
    test_zipfile: system/core/libzipfile
    genext2fs: external/genext2fs
    asm-3.1: prebuilt/common/asm
    create_test_dmtrace: dalvik/tools/dmtracedump
    libswt-pi-gtk-3236: prebuilt/linux-x86/swt
    libembunit: external/embunit
    swt: prebuilt/linux-x86/swt
    makedict: development/tools/makedict
    ddmlib: development/tools/ddms/libs/ddmlib/src
    platform.xml: frameworks/base/data/etc
    swing-worker-1.1: prebuilt/common/swing-worker
    makekeycodes: frameworks/base/tools/makekeycodes
    properties: frameworks/base/location/data
    libneo_util: external/clearsilver/util
Round 4
    libicudata-default: external/icu4c/stubdata
    libcutils: system/core/libcutils
    layoutlib_api: frameworks/base/tools/layoutlib/api
    procmem: system/extras/procmem
    servicemanager: frameworks/base/cmds/servicemanager
    layoutlib_create: frameworks/base/tools/layoutlib/create
    eventanalyzer: development/tools/eventanalyzer
    logcat: system/core/logcat
    sdklib: development/tools/sdkmanager/libs/sdklib/src
    libneo_cs: external/clearsilver/cs
    hierarchyviewer: development/tools/hierarchyviewer
    sdkstats: development/tools/sdkstats/src
    dumpeventlog: development/tools/dumpeventlog
    mkstubs: development/tools/mkstubs
    sqlite3: external/sqlite/dist
    jarutils: development/tools/jarutils/src
    procrank: system/extras/procrank
    libicudata-jp: external/icu4c/stubdata
    librank: system/extras/librank
    dexdump: dalvik/dexdump
    logwrapper: system/core/logwrapper
    libicudata-eu: external/icu4c/stubdata
    libicudata-us: external/icu4c/stubdata
    draw9patch: development/tools/draw9patch
    screenshot2: development/tools/screenshot
    libESR_Shared: external/srec/shared
    droiddoc: build/tools/droiddoc/src
    ddmuilib: development/tools/ddms/libs/ddmuilib/src
    AT_Translated_Set_2_keyboard.kcm: vendor/linuxfoundation/moblin
Round 5
    libSR_Core: external/srec/srec/ca
    ddms: development/tools/ddms/app
    libwpa_client: external/wpa_supplicant
    installd: frameworks/base/cmds/installd
    libutils: frameworks/base/libs/utils
    adbd: system/core/adb
    apkbuilder: development/tools/apkbuilder
    showmap: system/extras/showmap
    libicuuc: external/icu4c/common
    libSR_EventLog: external/srec/srec/EventLog
    radiooptions: hardware/ril/rild
    libnetutils: system/core/libnetutils
    libSR_G2P: external/srec/seti/sltsEngine
    backup: system/extras/backup
    libneo_cgi: external/clearsilver/cgi
    toolbox: system/core/toolbox
    libhgl: frameworks/base/opengl/libhgl
    android-init: system/core/init
    traceview: development/tools/traceview
    sdkuilib: development/tools/sdkmanager/libs/sdkuilib/src
    adb: system/core/adb
    dumpstate: frameworks/base/cmds/dumpstate
    layoutlib_utils: development/tools/layoutlib_utils
    dvz: dalvik/dvz
    dexlist: dalvik/dexlist
    check_prereq: build/tools/check_prereq
    libhardware: hardware/libhardware
Round 6
    libicui18n: external/icu4c/i18n
    localize: frameworks/base/tools/localize
    aapt: frameworks/base/tools/aapt
    anttasks: development/tools/anttasks/src
    libaudio: intel-extras/libaudio_pulse
    libxml2wbxml: packages/apps/IM/libwbxml
    libSR_Vocabulary: external/srec/srec/Vocabulary
    wdsclient: external/webkit/WebKit/android/wds/client
    libSR_Semproc: external/srec/srec/Semproc
    libdrm1_jni: frameworks/base/media/libdrm/mobile1
    libclearsilver-jni: external/clearsilver/java-jni
    libcorecg: external/skia
    gamb: frameworks/base/cmds/application_bridge
    service: frameworks/base/cmds/service
    sdkmanager: development/tools/sdkmanager/app/src
    libjni_pinyinime: packages/inputmethods/PinyinIME/PinyinIME/jni
    libdrm1: frameworks/base/media/libdrm/mobile1
    libwbxml: packages/apps/IM/libwbxml
    libwbxml_jni: packages/apps/IM/libwbxml
    libgtkwindow: frameworks/base/libs/gtkwindow
    libsimplejni: development/samples/SimpleJNI/jni
    libemoji: frameworks/opt/emoji
    libSR_AcousticModels: external/srec/srec/AcousticModels
    system_server: frameworks/base/cmds/system_server
    zipalign: build/tools/zipalign
    wbxmltest: packages/apps/IM/libwbxml
    libsonivox: external/sonivox/arm-wt-22k
    dumpsys: frameworks/base/cmds/dumpsys
    lights.default: hardware/libhardware/modules/lights
    libSR_AcousticState: external/srec/srec/AcousticState
    libhardware_legacy: hardware/libhardware_legacy
Round 7
    Snake: development/samples/Snake
    SoftKeyboard: development/samples/SoftKeyboard
    RSSReader: development/samples/RSSReader
    FixedGridLayout: development/samples/FixedGridLayout
    core: dalvik/libcore
    LunarLander: development/samples/LunarLander
    libpixelflinger: system/core/libpixelflinger
    timeinfo: system/extras/timeinfo
    ApiDemos: development/samples/ApiDemos
    gtkwindow: frameworks/base/cmds/gtkwindow
    Compass: development/samples/Compass
    libsgl: external/skia
    Home: development/samples/Home
    libril: hardware/ril/libril
    NotePad: development/samples/NotePad
    libsqlite: external/sqlite/dist
    HelloActivity: development/samples/HelloActivity
    SkeletonApp: development/samples/SkeletonApp
    libSR_Grammar: external/srec/srec/Grammar
    framework-res: frameworks/base/core/res
    core-tests: dalvik/libcore
    libSR_Nametag: external/srec/srec/Nametag
    AliasActivity: development/samples/AliasActivity
Round 8
    libSR_Recognizer: external/srec/srec/Recognizer
    libui: frameworks/base/libs/ui
    libnativehelper: dalvik/libnativehelper
    test-opengl-codegen: system/core/libpixelflinger/tests/codegen
    ext: frameworks/base
    libagl: frameworks/base/opengl/libagl
    rild: hardware/ril/rild
    libSR_Session: external/srec/srec/Session
    libreference-ril: hardware/ril/reference-ril
    framework: frameworks/base
Round 9
    am: frameworks/base/cmds/am
    svc: frameworks/base/cmds/svc
    monkey: development/cmds/monkey
    com.example.android.platform_library: development/samples/PlatformLibrary
    make_cfst: external/srec/tools/make_cfst
    libexif: external/jhead
    Term: development/apps/Term
    SubscribedFeedsProvider: frameworks/base/packages/SubscribedFeedsProvider
    ime: frameworks/base/cmds/ime
    android.policy_mid: frameworks/policies/base/mid
    Settings: packages/apps/Settings
    FontLab: development/apps/FontLab
    DisabledTestApp: frameworks/base/tests/AndroidTests/DisabledTestApp
    SpareParts: development/apps/SpareParts
    libdvm: dalvik/vm
    JETBoy: development/samples/JetBoy
    Stk: packages/apps/Stk
    libgstreamer: intel-extras/gstreamerplayer
    DensityTest: frameworks/base/tests/DpiTest
    libmedia: frameworks/base/media/libmedia
    AppWidgetProvider: frameworks/base/tests/appwidgets/AppWidgetProviderTest
    DownloadProvider: packages/providers/DownloadProvider
    TelephonyProvider: packages/providers/TelephonyProvider
    make_g2g: external/srec/tools/make_g2g
    android.test.runner: frameworks/base/test-runner
    input: frameworks/base/cmds/input
    GoogleSearch: packages/apps/GoogleSearch
    Phone: packages/apps/Phone
    AppWidgetHostTest: frameworks/base/tests/appwidgets/AppWidgetHostTest
    GoogleContactsProvider: packages/providers/GoogleContactsProvider
    libGLESv1_CM: frameworks/base/opengl/libs
    Email: packages/apps/Email
    SdkSetup: development/apps/SdkSetup
    make_ve_grammar: external/srec/tools/make_ve_grammar
    MediaProvider: packages/providers/MediaProvider
    android.policy_phone: frameworks/policies/base/phone
    DrmProvider: packages/providers/DrmProvider
    Camera: packages/apps/Camera
    Fallback: development/apps/Fallback
    libcamera: intel-extras/libcamera_v4l2
    PinyinIME: packages/inputmethods/PinyinIME/PinyinIME
    parseStringTest: external/srec/tools/parseStringTest
    Contacts: packages/apps/Contacts
    HTMLViewer: packages/apps/HTMLViewer
    GoogleSubscribedFeedsProvider: packages/providers/GoogleSubscribedFeedsProvider
    dictTest: external/srec/tools/dictTest
    PackageInstaller: packages/apps/PackageInstaller
    libEGL: frameworks/base/opengl/libs
    ContactsProvider: packages/providers/ContactsProvider
    test_g2g: external/srec/tools/test_g2g
    SimpleJNI: development/samples/SimpleJNI
    Calculator: packages/apps/Calculator
    AlarmClock: packages/apps/AlarmClock
    android.awt: frameworks/base/awt
    Launcher: packages/apps/Launcher
    test_swiarb: external/srec/tools/test_swiarb
    SoundRecorder: packages/apps/SoundRecorder
    ImfTest: frameworks/base/tests/ImfTest
    pm: frameworks/base/cmds/pm
    SslLoad: frameworks/base/tests/SslLoad
    EnabledTestApp: frameworks/base/tests/AndroidTests/EnabledTestApp
    com.android.im.plugin: packages/apps/IM/plugin
    CalendarProvider: packages/providers/CalendarProvider
    VoiceDialer: packages/apps/VoiceDialer
    com.android.inputmethod.pinyin.lib: packages/inputmethods/PinyinIME/PinyinIME/lib
    CustomLocale: development/apps/CustomLocale
    services: frameworks/base/services/java
    Music: packages/apps/Music
    GlobalTime: development/samples/GlobalTime
    SettingsProvider: frameworks/base/packages/SettingsProvider
    checkapi: 
    grxmlcompile: external/srec/tools/grxmlcompile
    temp_layoutlib: frameworks/base/tools/layoutlib
    StatusBarTest: frameworks/base/tests/StatusBar
Round 10
    test-opengl-filter: frameworks/base/opengl/tests/filter
    ImfTestTests: frameworks/base/tests/ImfTest/tests
    test-opengl-textures: frameworks/base/opengl/tests/textures
    DumpRenderTree: frameworks/base/tests/DumpRenderTree
    Browser: packages/apps/Browser
    EmailTests: packages/apps/Email/tests
    gpustate: frameworks/base/opengl/tests/angeles
    CoreTests: frameworks/base/tests/CoreTests/android
    CalendarProviderTests: packages/providers/CalendarProvider/tests
    layoutlib: frameworks/base/tools/layoutlib/bridge
    libaudioflinger: frameworks/base/libs/audioflinger
    prebuilt: 
    Calendar: packages/apps/Calendar
    test-opengl-tritex: frameworks/base/opengl/tests/tritex
    SmokeTestApp: frameworks/base/tests/SmokeTest
    libsrec_jni: external/srec/srec_jni
    CalculatorTests: packages/apps/Calculator/tests
    framework-tests: frameworks/base/tests/framework-tests/src
    launchperf: development/apps/launchperf
    libskiagl: external/skia
    libcameraservice: frameworks/base/camera/libcameraservice
    PlatformLibraryClient: development/samples/PlatformLibrary/client
    ImProvider: packages/providers/ImProvider
    SnakeTests: development/samples/Snake/tests
    MusicTests: packages/apps/Music/tests
    Mms: packages/apps/Mms
    GoogleContactsProviderTests: packages/providers/GoogleContactsProvider/tests
    libsurfaceflinger: frameworks/base/libs/surfaceflinger
    IM: packages/apps/IM
    ContactsTests: packages/apps/Contacts/tests
    dexopt: dalvik/dexopt
    dalvikvm: dalvik/dalvikvm
    SkeletonAppTests: development/samples/SkeletonApp/tests
    ApiDemosTests: development/samples/ApiDemos/tests
    mediaframeworktest: frameworks/base/media/tests/MediaFrameworkTest
    test-opengl-finish: frameworks/base/opengl/tests/finish
    FrameworkTest: frameworks/base/tests/FrameworkTest
    HelloActivityTests: development/samples/HelloActivity/tests
    CameraTests: packages/apps/Camera/tests
    libgstmediarecorder: intel-extras/gstmediarecorder
    Development: development/apps/Development
    SettingsTests: packages/apps/Settings/tests
    NotePadTests: development/samples/NotePad/tests
    LunarLanderTests: development/samples/LunarLander/tests
    angeles: frameworks/base/opengl/tests/angeles
Round 11
    libandroid_runtime: frameworks/base/core/jni
    AudioHardwareRecord: external/srec/audio/test/AudioHardwareRecord
    SRecTestAudio: external/srec/srec/test/SRecTestAudio
    SRecTest: external/srec/srec/test/SRecTest
    AudioInRecord: external/srec/audio/test/AudioInRecord
    CalendarTests: packages/apps/Calendar/tests
    FrameworkTestTests: frameworks/base/tests/FrameworkTest/tests
    SmokeTest: frameworks/base/tests/SmokeTest/tests
    surfaceflinger: frameworks/base/cmds/surfaceflinger
    AndroidTests: frameworks/base/tests/AndroidTests
    AudioHardwareRecordLoop: external/srec/audio/test/AudioHardwareRecordLoop
Round 12
    libopencore_rtspreg: external/opencore/build_config/opencore_dynamic
    libpvoma1passthru: external/opencore/build_config/opencore_dynamic
    libomx_amrdec_sharedlibrary: external/opencore/build_config/opencore_dynamic
    libopencore_downloadreg: external/opencore/build_config/opencore_dynamic
    libomx_avcenc_sharedlibrary: external/opencore/build_config/opencore_dynamic
    libopencore_mp4local: external/opencore/build_config/opencore_dynamic
    libomx_amrenc_sharedlibrary: external/opencore/build_config/opencore_dynamic
    libopencore_rtsp: external/opencore/build_config/opencore_dynamic
    libopencore_net_support: external/opencore/build_config/opencore_dynamic
    libopencore_author: external/opencore/build_config/opencore_dynamic
    libopencore_player: external/opencore/build_config/opencore_dynamic
    libomx_m4vdec_sharedlibrary: external/opencore/build_config/opencore_dynamic
    libomx_m4venc_sharedlibrary: external/opencore/build_config/opencore_dynamic
    libFFTEm: external/neven
    libomx_sharedlibrary: external/opencore/build_config/opencore_dynamic
    libopencore_download: external/opencore/build_config/opencore_dynamic
    libwebcore: external/webkit
    app_process: frameworks/base/cmds/app_process
    libplatform_library_jni: development/samples/PlatformLibrary/jni
    libomx_avcdec_sharedlibrary: external/opencore/build_config/opencore_dynamic
    libsoundpool: frameworks/base/media/jni/soundpool
    libopencore_common: external/opencore/build_config/opencore_dynamic
    libmediaplayerservice: frameworks/base/media/libmediaplayerservice
    libopencore_mp4localreg: external/opencore/build_config/opencore_dynamic
    libomx_mp3dec_sharedlibrary: external/opencore/build_config/opencore_dynamic
    libomx_aacdec_sharedlibrary: external/opencore/build_config/opencore_dynamic
Round 13
    libmedia_jni: frameworks/base/media/jni
    libsystem_server: frameworks/base/cmds/system_server/library
    mediaserver: frameworks/base/media/mediaserver
Round 14
    libandroid_servers: frameworks/base/services/jni
Round 15
    files: 
Round 16
    droidcore: 
